ID,Core_Level,Design,Front,Back,Game,Business
COD0,1,1,2,3,4,0
COD1,1,2,1,3,4,0
COD2,2,3,2,1,4,5
COD3,3,4,3,2,1,5
COD4,4,5,4,3,2,1
COD5,5,0,5,4,3,2
COD6,0,1,2,5,4,3
COD7,3,1,2,3,5,4
COD8,5,2,2,3,4,5
COD9,1,4,4,3,4,5
